//MAP CONVERTED BY dmm2tgm.py THIS HEADER COMMENT PREVENTS RECONVERSION, DO NOT REMOVE
"as" = (
/obj/machinery/door/airlock/external/glass,
/obj/effect/mapping_helpers/airlock/cyclelink_helper,
/turf/open/floor/plating,
/area/ruin/unpowered)
"aY" = (
/obj/machinery/door/airlock/external/glass,
/obj/effect/mapping_helpers/airlock/cyclelink_helper{
	dir = 1
	},
/turf/open/floor/plating,
/area/ruin/unpowered)
"bf" = (
/obj/machinery/door/airlock/maintenance_hatch,
/turf/open/floor/plating/airless,
/area/template_noop)
"bj" = (
/obj/structure/frame/computer,
/turf/open/floor/mineral/titanium/airless,
/area/template_noop)
"cY" = (
/obj/machinery/door/airlock/external/glass,
/obj/effect/mapping_helpers/airlock/cyclelink_helper{
	dir = 4
	},
/turf/open/floor/plating,
/area/ruin/unpowered)
"eq" = (
/obj/effect/abstract/doorway_marker{
	dir = 4
	},
/turf/open/floor/plasteel,
/area/ruin/unpowered)
"hf" = (
/turf/closed/wall,
/area/ruin/unpowered)
"ib" = (
/obj/machinery/shuttle/engine/plasma{
	dir = 1
	},
/turf/open/floor/plating/airless,
/area/template_noop)
"ig" = (
/obj/structure/door_assembly/door_assembly_mhatch,
/turf/open/floor/plating/airless,
/area/template_noop)
"iR" = (
/obj/effect/turf_decal/stripes/line{
	dir = 1
	},
/turf/open/floor/plating/airless,
/area/template_noop)
"mf" = (
/obj/structure/closet/firecloset/full,
/turf/open/floor/plating/airless,
/area/template_noop)
"nu" = (
/turf/open/floor/mineral/titanium/airless,
/area/template_noop)
"nT" = (
/obj/item/shuttle_creator,
/obj/machinery/light/built{
	dir = 8
	},
/obj/item/radio/intercom{
	pixel_y = -27
	},
/turf/open/floor/mineral/titanium/airless,
/area/template_noop)
"ob" = (
/obj/machinery/atmospherics/components/unary/portables_connector{
	dir = 8
	},
/obj/machinery/portable_atmospherics/canister/toxins,
/turf/open/floor/plating/airless,
/area/template_noop)
"rJ" = (
/obj/structure/door_assembly/door_assembly_com,
/turf/open/floor/mineral/titanium/airless,
/area/template_noop)
"sH" = (
/obj/machinery/atmospherics/components/unary/shuttle/heater{
	dir = 1
	},
/obj/structure/window/reinforced/spawner,
/obj/machinery/door/window/northleft,
/turf/open/floor/plating/airless,
/area/template_noop)
"ts" = (
/obj/structure/closet/emcloset,
/obj/effect/turf_decal/stripes/line{
	dir = 8
	},
/obj/effect/spawner/lootdrop/ruinloot/basic,
/turf/open/floor/plasteel,
/area/ruin/unpowered)
"tP" = (
/obj/effect/turf_decal/stripes/line{
	dir = 8
	},
/obj/structure/grille,
/turf/open/floor/plating/airless,
/area/template_noop)
"vJ" = (
/obj/item/stock_parts/cell/crap,
/turf/open/floor/plating/airless,
/area/template_noop)
"wW" = (
/obj/effect/turf_decal/stripes/line{
	dir = 8
	},
/turf/open/floor/plating/airless,
/area/template_noop)
"zv" = (
/obj/machinery/light/built{
	dir = 4
	},
/turf/open/floor/plating/airless,
/area/template_noop)
"Ah" = (
/turf/open/floor/plating,
/area/template_noop)
"AE" = (
/obj/effect/turf_decal/stripes/line,
/turf/open/floor/plating/airless,
/area/template_noop)
"AI" = (
/obj/item/storage/toolbox/mechanical,
/turf/open/floor/plating/airless,
/area/template_noop)
"AT" = (
/obj/machinery/door/airlock/external/glass,
/obj/effect/mapping_helpers/airlock/cyclelink_helper{
	dir = 8
	},
/turf/open/floor/plating,
/area/ruin/unpowered)
"Cc" = (
/obj/effect/turf_decal/stripes/line{
	dir = 8
	},
/obj/structure/grille/broken,
/turf/open/floor/plating/airless,
/area/template_noop)
"CJ" = (
/obj/item/wallframe/apc,
/obj/item/electronics/apc,
/turf/open/floor/plating/airless,
/area/template_noop)
"CZ" = (
/obj/item/stack/sheet/glass/fifty,
/turf/open/floor/plating/airless,
/area/template_noop)
"Dg" = (
/obj/effect/turf_decal/stripes/line{
	dir = 9
	},
/turf/open/floor/plating/airless,
/area/template_noop)
"EO" = (
/obj/effect/turf_decal/stripes/line{
	dir = 10
	},
/turf/open/floor/plating/airless,
/area/template_noop)
"Fw" = (
/obj/machinery/door/airlock/external/glass,
/obj/effect/mapping_helpers/airlock/cyclelink_helper{
	dir = 4
	},
/turf/open/floor/plating,
/area/template_noop)
"Fx" = (
/obj/machinery/atmospherics/components/unary/shuttle/heater{
	dir = 1
	},
/obj/structure/window/reinforced/spawner,
/obj/machinery/door/window/northright,
/turf/open/floor/plating/airless,
/area/template_noop)
"FW" = (
/obj/effect/turf_decal/stripes/line{
	dir = 4
	},
/turf/open/floor/plating/airless,
/area/template_noop)
"Gl" = (
/obj/effect/turf_decal/stripes/line{
	dir = 8
	},
/turf/open/floor/plasteel,
/area/ruin/unpowered)
"GG" = (
/obj/machinery/atmospherics/pipe/manifold/purple/visible{
	dir = 1
	},
/turf/open/floor/plating/airless,
/area/template_noop)
"Hx" = (
/turf/template_noop,
/area/template_noop)
"HD" = (
/obj/structure/closet/firecloset,
/obj/effect/turf_decal/stripes/line{
	dir = 8
	},
/turf/open/floor/plasteel,
/area/ruin/unpowered)
"IO" = (
/obj/structure/sign/poster/random{
	pixel_x = 32
	},
/turf/open/floor/plasteel,
/area/ruin/unpowered)
"Ky" = (
/obj/machinery/computer/shuttle/custom_shuttle,
/turf/open/floor/mineral/titanium/airless,
/area/template_noop)
"KA" = (
/obj/effect/spawner/structure/window/reinforced,
/turf/open/floor/plating,
/area/ruin/unpowered)
"MD" = (
/obj/structure/girder,
/turf/open/floor/plating/airless,
/area/template_noop)
"Oy" = (
/obj/structure/sign/nanotrasen{
	pixel_x = 32
	},
/turf/open/floor/plasteel,
/area/ruin/unpowered)
"OB" = (
/obj/effect/turf_decal/stripes/line{
	dir = 6
	},
/turf/open/floor/plating/airless,
/area/template_noop)
"Ps" = (
/obj/item/kirbyplants/random,
/obj/effect/turf_decal/stripes/line{
	dir = 8
	},
/turf/open/floor/plasteel,
/area/ruin/unpowered)
"PH" = (
/obj/effect/spawner/structure/window/shuttle,
/turf/open/floor/plating,
/area/template_noop)
"PL" = (
/obj/machinery/atmospherics/pipe/simple/purple/visible,
/turf/open/floor/plating/airless,
/area/template_noop)
"Qz" = (
/obj/structure/tank_dispenser/oxygen,
/turf/open/floor/plating/airless,
/area/template_noop)
"Sk" = (
/obj/item/electronics/airlock,
/turf/open/floor/plating/airless,
/area/template_noop)
"Sx" = (
/obj/machinery/atmospherics/components/unary/shuttle/heater{
	dir = 1
	},
/obj/structure/window/reinforced/spawner,
/obj/structure/window/reinforced/spawner/east,
/obj/structure/window/reinforced/spawner/west,
/obj/machinery/door/window/northright,
/turf/open/floor/plating/airless,
/area/template_noop)
"Th" = (
/obj/machinery/vending/coffee,
/obj/effect/turf_decal/stripes/line{
	dir = 8
	},
/obj/effect/turf_decal/stripes/corner{
	dir = 4
	},
/turf/open/floor/plasteel,
/area/ruin/unpowered)
"Tj" = (
/turf/open/floor/plating/airless,
/area/template_noop)
"TV" = (
/obj/machinery/atmospherics/components/unary/plasma_refiner{
	dir = 4
	},
/turf/open/floor/plating/airless,
/area/template_noop)
"Vz" = (
/turf/open/floor/plating,
/area/ruin/unpowered)
"VW" = (
/obj/effect/turf_decal/stripes/line{
	dir = 1
	},
/turf/open/floor/plasteel,
/area/ruin/unpowered)
"Wh" = (
/turf/closed/wall/mineral/titanium,
/area/template_noop)
"WJ" = (
/obj/effect/abstract/open_area_marker,
/turf/open/floor/plasteel,
/area/ruin/unpowered)
"WT" = (
/obj/machinery/door/airlock/external/glass,
/obj/effect/mapping_helpers/airlock/cyclelink_helper{
	dir = 8
	},
/turf/open/floor/plating,
/area/template_noop)
"XY" = (
/obj/machinery/atmospherics/pipe/simple/purple/visible{
	dir = 4
	},
/turf/open/floor/plating/airless,
/area/template_noop)
"Zp" = (
/turf/open/floor/plasteel,
/area/ruin/unpowered)

(1,1,1) = {"
Hx
Hx
Hx
Hx
Hx
Hx
Hx
Hx
Hx
Hx
Hx
Hx
Hx
Hx
Hx
Hx
Hx
Hx
Hx
Hx
Hx
"}
(2,1,1) = {"
Hx
Hx
Hx
Hx
Hx
Hx
Hx
Dg
wW
EO
Hx
Hx
Hx
Hx
Hx
Hx
Hx
Hx
Hx
Hx
Hx
"}
(3,1,1) = {"
Hx
Hx
Hx
Hx
Hx
Hx
Hx
iR
Tj
AE
wW
EO
Hx
Hx
Hx
Hx
Hx
Hx
Hx
Hx
Hx
"}
(4,1,1) = {"
Hx
Hx
Hx
Hx
Hx
Hx
Wh
tP
tP
Cc
Wh
Wh
Wh
Wh
Wh
Hx
Hx
Hx
Hx
Hx
Hx
"}
(5,1,1) = {"
Hx
Hx
Hx
Hx
Wh
Wh
Wh
Tj
Tj
Tj
Wh
Tj
Tj
Tj
Wh
Wh
Wh
Hx
Hx
Hx
Hx
"}
(6,1,1) = {"
Hx
Hx
Hx
Wh
Wh
mf
Wh
Tj
Tj
CZ
MD
Tj
Tj
Tj
Wh
TV
Wh
Wh
Hx
Hx
Hx
"}
(7,1,1) = {"
Hx
Hx
Hx
Wh
Tj
Tj
ig
Tj
zv
Tj
Tj
Tj
Tj
Tj
Wh
GG
PL
sH
ib
Hx
Hx
"}
(8,1,1) = {"
Hx
Hx
Wh
Wh
bf
Wh
Wh
Tj
Wh
Tj
Wh
Wh
Tj
Wh
Wh
XY
Tj
Wh
Wh
Hx
Hx
"}
(9,1,1) = {"
Hx
Hx
PH
bj
nu
nT
Wh
Tj
Tj
Tj
Tj
Tj
Tj
Qz
Wh
GG
PL
PL
sH
ib
Hx
"}
(10,1,1) = {"
Hx
Hx
PH
Ky
nu
nu
rJ
Tj
Tj
Tj
Tj
Tj
Tj
Tj
Sk
GG
PL
PL
Sx
ib
Hx
"}
(11,1,1) = {"
Hx
Hx
PH
bj
nu
nu
Wh
Tj
AI
Tj
Tj
Tj
Tj
Tj
Tj
GG
PL
PL
Fx
ib
Hx
"}
(12,1,1) = {"
Hx
Hx
Wh
Wh
ig
Wh
Wh
Wh
Tj
Wh
Wh
Wh
Tj
Tj
Tj
XY
Tj
Wh
Wh
Hx
Hx
"}
(13,1,1) = {"
Hx
Hx
Hx
Wh
Tj
Tj
bf
CJ
Tj
Tj
Tj
Tj
Tj
Tj
MD
GG
PL
Fx
ib
Hx
Hx
"}
(14,1,1) = {"
Hx
Hx
Hx
Wh
Wh
Tj
Wh
vJ
Tj
Tj
Tj
Tj
Tj
Tj
MD
ob
Wh
Wh
Hx
Hx
Hx
"}
(15,1,1) = {"
Hx
Hx
Hx
Hx
Wh
Wh
Wh
Tj
Tj
Tj
Tj
Tj
Tj
Tj
Wh
Wh
Wh
Hx
Hx
Hx
Hx
"}
(16,1,1) = {"
Hx
Hx
Hx
Hx
Hx
Hx
Wh
Wh
Fw
Wh
Wh
Wh
Wh
Wh
Wh
Hx
Hx
Hx
Hx
Hx
Hx
"}
(17,1,1) = {"
Hx
Hx
Hx
Hx
Hx
Hx
Hx
Wh
Ah
Wh
FW
OB
Hx
Hx
Hx
Hx
Hx
Hx
Hx
Hx
Hx
"}
(18,1,1) = {"
Hx
Hx
Hx
Hx
Hx
Hx
Hx
Wh
WT
Wh
Hx
Hx
Hx
Hx
Hx
Hx
Hx
Hx
Hx
Hx
Hx
"}
(19,1,1) = {"
Hx
Hx
Hx
Hx
Hx
Hx
Hx
KA
cY
KA
Hx
Hx
Hx
Hx
Hx
Hx
Hx
Hx
Hx
Hx
Hx
"}
(20,1,1) = {"
Hx
Hx
Hx
hf
KA
KA
KA
KA
Vz
KA
KA
KA
KA
hf
Hx
Hx
Hx
Hx
Hx
Hx
Hx
"}
(21,1,1) = {"
Hx
Hx
Hx
hf
Th
HD
ts
KA
AT
KA
Gl
Gl
Ps
hf
hf
hf
hf
hf
hf
hf
hf
"}
(22,1,1) = {"
Hx
KA
KA
KA
VW
Zp
Zp
Zp
Zp
Zp
Zp
Zp
Zp
Zp
Zp
Zp
Zp
Zp
Zp
Zp
Zp
"}
(23,1,1) = {"
Hx
as
Vz
aY
VW
Zp
Zp
Zp
Zp
Zp
Zp
Zp
Zp
Zp
Zp
Zp
Zp
Zp
Zp
Zp
WJ
"}
(24,1,1) = {"
Hx
KA
KA
KA
VW
Zp
Zp
Zp
Zp
Zp
Oy
Zp
Zp
Zp
IO
Zp
Zp
Zp
Zp
Zp
Zp
"}
(25,1,1) = {"
Hx
Hx
Hx
hf
hf
hf
eq
hf
hf
hf
hf
hf
hf
hf
hf
hf
hf
hf
eq
hf
hf
"}
